0,0,0,u,u,u,0,0,0,0
0,0,0,0,0,0,0,0,z,0
0,0,0,0,0,0,0,0,z,0
0,0,0,0,0,0,0,0,z,0
0,0,0,w,0,0,0,0,z,0
0,0,0,w,0,0,0,0,0,0
0,0,0,0,0,0,0,0,0,0
0,0,0,0,0,0,v,v,v,0
y,y,y,y,y,0,0,0,0,0
0,0,0,0,0,0,0,0,0,0